NO ./path_to_the_north_texture
SO ./path_to_the_south_texture
WE ./path_to_the_west_texture
EA ./path_to_the_east_texture

F 220,100,0
C 225,0,9

    111111111111
    100100000001
    100100011001
    10N000010101
    1000011 1011
    111001010001
    101001000001
    111111111111




